....###################..
#...#..........#.....####
#.###.#.##########.######
#.....#............#..###
#####.#####.#######.#####
#.....#........#......###
#.#.#####.####.#.########
#...#....#............###
#.###.###.#.#############
#...#..........#......###
#####.#.#######.#.#.#####
#.....#.#...........#.#..
###.###.#.#######.#######
#.#...#..........#.....#.
# #####.#####.#####.##.#.
#.....#...........#.#.#..
###.#####.#####.#.#.#.#..
#.#.........#.#.........#
#.#.#########.#.#######.#
#...#...........#.....#..