...##.........#......##
#.###.#####.###.#######
#...#.......#....#....#
###.#.###.#.#.#.#.##.##
#.....#...#.#.#......##
#.#####.###.#.#####.###
#.#.....#.....#.......#
#.###.###.#####.#####.#
#.....#...........#...#
#####.#.#####.#.###.###
#...#.#.....#.....#...#
#.###.###.###.#####.#.#
#...#...............#.#
#.#.#####.#######.###.#
#...#...#.....#.....#.#
#####.#.###.#.#######.#
#.....#...#.#.........#
#.###.#####.#.#######.#
####..#...###..........