...############################.
#.............#.......#........#
#.###.#.#####.#.#####.#.######.#
#.....#.......#.....#..........#
#####.#.#.###.###.###.#.#.####.#
#...#...#...#.......#.#........#
#.###.###.#.#.#.##.#.#.#####.#.#
#.....#...#.#.#..#...#.....#...#
#.###.###.#.#.##.#####.###.#.#.#
#...........#......#.....#...#.#
#.#####.#.###.#.##.#.#####.#.#.#
#.#...#.......#.#..#.....#.#...#
#.###.#######.##.#.#.###.#.###.#
#...#.......#....#.....#.......#
#.#.#####.#.######.###.#.#.###.#
#...#...#.#.......#...#.#.....#.
#####.#.#.###.#####.#.#.##.####.
#.........#.......#.#....#...##.
###....####..#####...#######....